..............................................
..............................................
..............................................
..............................................
..............................................
..............................................
..............................................
..............................................
..............................................
..............................................
..............~............................S.S
OOOOOOOOOOOOOOOOOOOOOOOOOOOOOOOOOOOOOOOOOOOOOO
..............................................
..............................................
..............................................
..............................................
..............................................
..............................................
..............................................