.......................................................................................................................................................................................OO.....OO....OO............................................................................................................................................F
...................................................................................................................................................................................................................................................................................................................................................F
......................................................................................................................................................................................O..O...O..O..O..O............................................................................................................................................F
.......................................................................................................................................................................................OO.....OO....OO..................................S..........................................................................................................F
.........................................................SOOO...........................................................................................................................................................................O..........................................................................................................F
......................................................SOOO...OOO........................................................................................................S.....S.........................................................O.........................................................................................................OF
...................................................SOOO.........OOO.........................................................................S.........S.........OOOOOOOOOOOOOOOOOO.............................................................................................................................................................O..OF
.............S.....S...........OOOOO............SOOO...............OOO..................................................S.......S......OOOOOOOOOOOOOOOOOOOOOOOOO...............OOOO.....................................S.......O...............................................................O..........................O................O..O..OF
.....~.......O.....O........OOOOOOOOOOO.......OOO.....................OOO........S.......S.........S........OOOOOOOOOOOOOOOOOOOOOOOOOOO........................................OOOOO......S.......SS........SSS.........O.......O.......O........SS.......S..........S.........OOOO.....S.......O.........O......OOOO......O.....O.......O..O..O..OF
.....OOOOOOOOOOOOOOOOOOOOOOOOOOOOOOOOOOOOOOOOOOOOOOOOOOOOOOOOOOOOOOOOOOOOOOOOOOOOOOOOOOOOOOOOOOOOOOOOOOOOOOOOOOOOOOOOOOOOOOOOOOOOOOOOOOOOOOOOOOOOOOOOOOOOOOOOOOOOOOOOOOOOOOOOOOOOOOOOOOOOOOOOOOOOOOOOOOOOOOOOOOOOOOOOOOOOOOOOOOOOOOOOOOOOOOOOOOOOOOOOOOOOOOOOOOOOOOOOOOOOOOOOOOOOOOOOOOOOOOOOOOOOOOOOOOOOOOOOOOOOOOOOOOOOOOOOOOOOOOOOOOOOOOOOOOOOOOF
