.............
..............
..............
..............
..............
..............
..............
..............
..............
......~....SSS
......OOOOOOOO
