...........
............
............
............
............
............
............
............
............
.......~....
........OOOO
........OOOO
