...............................................................................................................................................................................................................................................................................................................................................F
................................................................................................................................................................................................................................................................................................................................................F
................................................................................................................................................................................................................................................................................................SSS.............................................F
................................................................................................................................................................................................................................................................................................OOO.............................................F
...................................................................................................................................................................................................................OOOOO...................................................................OOO..................................................F
........................................................................................OOOOOO.............S......................O....................S.....OOO................................................OOOOOOOOOOO..........................................O...............OOO........................OO..............................F
.....~.......SOOOS........OOO........SS.............SS........SS...............S.S.....OOOOOOOO...SS.......O........OOOOOOOO......O......S....O........O.....OOO.....SS........S.........S...........S.......OOOOOOOOOOOOOOOOO............SS.......S.........S.......O........O.................................OO.............SSS........SS....F
...OOOOOOOOOOOOOOOOOOOOOOOOOOOOOOOOOOOOOOOOOOOOOOOOOOOOOOOOOOOOOOOOOOOOOOOOOOOOOOOOOOOOOOOOOOOOOOOOOOOOOOOOOOOOOOOOOOOOOOOOOOOOOOOOOOOOOOOOOOOOOOOOOOOOOOOOOOOOOOOOOOOOOOOOOOOOOOOOOOOOOOOOOOOOOOOOOOOOOOOOOOOOOOOOOOOOOOOOOOOOOOOOOOOOOOOOOOOOOOOOOOOOOOOOOOOOOOOOOOOOOOOOOOOOOOOOOOOOOOOOOOOOOOOOOOOOOOOOOOOOOOOOOOOOOOOOOOOOOOOOOOOOOOOOOOOOOO
