..........................................................................................................................................................................................................................................................
..........................................................................................................................................................................................................................................................
..........................................................................................................................................................................................................................................................
..........................................................................................................................................................................................................................................................
.........................................................................................O..........................................................................................................................................................F.....
....................................................................................O....O....................................................................S.......S.......S.....................................................................F.....
.....~........................S................SS...............SSS.............O...O....OSSS..............SS...SS...SS...SS...SS...SS...SS........S..........O.......O.......O.........SSS.....SSS.........S............S...........S.....SSS......F.....
.OOOOOOOOOOOOOOOOOOOOOOOOOOOOOOOOOOOOOOOOOOOOOOOOOOOOOOOOOOOOOOOOOOOOOOOOOOOOOOOOOOOOOOOOOOOOOOOOOOOOOOOOOOOOOOOOOOOOOOOOOOOOOOOOOOOOOOOOOOOOOOOOOOOOOOOOOOOOOOOOOOOOOOOOOOOOOOOOOOOOOOOOOOOOOOOOOOOOOOOOOOOOOOOOOOOOOOOOOOOOOO.OOOOOOOOOOOOOOOOOOOOOOOOOO
..............................................................................................................................................................................................................................OSO.........................
...............................................................................................................................................................................................................................O..........................
