........................
.........................
.........................
.........................
.........................
.........................
.........................
.........................
.........................
.........................
.........................
.........................
.........................
..............~..........
OOOOOOOOOOOOOOOOOOOOOOOOO
