................
................
................
.....~.......F..
OOOOOOOOOOOOOOOO
